		 CHURCH ENTRY
################################
#..............................>
#..######...............######.#
#..#....#.......@.......#....#.#
#..#....#...............#....#.#
#..######...........!...######.#
#...............U..............#
################################