	RECTORY
################
<..............#
#..............#
#..............#
################